а	сочинительный	противительный
а вдобавок	сочинительный	присоединительный
а именно	сочинительный	пояснительный
а также	сочинительный	присоединительный
а то	сочинительный	присоединительный
благодаря тому что	подчинительный	причинный
благо	подчинительный	причинный
буде	подчинительный	условный
будто	подчинительный	сравнительный
вдобавок	сочинительный	присоединительный
в результате чего	подчинительный	следственный
в результате того что	подчинительный	причинный
в связи с тем что	подчинительный	причинный
в силу того что	подчинительный	причинный
в случае если	подчинительный	условный
в то время как	подчинительный	сопоставительный
в том случае если	подчинительный	условный
в силу чего	подчинительный	присоединительный
ввиду того что	подчинительный	причинный
вопреки тому что	подчинительный	уступительный
вроде того как	подчинительный	сравнительный
вследствие чего	подчинительный	присоединительный
вследствие того что	подчинительный	причинный
да вдобавок	сочинительный	присоединительный
да еще	сочинительный	присоединительный
да (= и)	сочинительный	соединительный
да (= но)	сочинительный	противительный
да и	сочинительный	присоединительный
да и то	сочинительный	присоединительный
дабы	подчинительный	целевой
даже	сочинительный	присоединительный
даром что	подчинительный	уступительный
для того чтобы	подчинительный	целевой
же	сочинительный	противительный
едва	подчинительный	временной
едва…, как	подчинительный	временной
едва…, лишь	подчинительный	временной
ежели	подчинительный	условный, причинный
если	подчинительный	условный, причинный
если бы	подчинительный	сравнительный
если не…, то	сочинительный	сопоставительно-противопоставительный
если…, то	подчинительный	условный, сопоставительный
затем чтобы	подчинительный	целевой
затем что	подчинительный	причинный
зато	сочинительный	противительный
зачем	подчинительный	присоединительный
и	сочинительный	соединительный
и все же	подчинительный	уступительный
и значит	подчинительный	причинно-следственный
а именно	сочинительный	пояснительный
и поэтому	подчинительный	причинно-следственный
и притом	сочинительный	присоединительный
и все-таки	подчинительный	уступительный
и следовательно	подчинительный	причинно-следственный
и то	сочинительный	присоединительный
и тогда	подчинительный	времени
и еще	сочинительный	присоединительный
и…, и	сочинительный	соединительный
ибо	подчинительный	причинный
и вдобавок	сочинительный	присоединительный
из-за того что	подчинительный	причинный
или	сочинительный	разделительный, пояснительный
или…, или	сочинительный	разделительный
кабы	подчинительный	условный
как	подчинительный	сравнительный, условный, присоединительный, временной
Как скоро	подчинительный	условный
как будто	подчинительный	сравнительный
как если бы	подчинительный	сравнительный
как словно	подчинительный	сравнительный
как только	подчинительный	временной
как…, так и	сочинительный	сопоставительно-противопоставительный
как-то?	сочинительный	присоединительный
когда	подчинительный	временной, условный
когда…, то	подчинительный	временной
коли	подчинительный	условный, причинный
к тому же	сочинительный	присоединительный
кроме того	сочинительный	присоединительный
ли…, ли	сочинительный	разделительный
либо	сочинительный	разделительный
либо…, либо	сочинительный	разделительный
лишь	подчинительный	временной
лишь бы	подчинительный	целевой
лишь только	подчинительный	временной
между тем как	подчинительный	сопоставительный
нежели	подчинительный	сравнительный
не столько…, сколько	сочинительный	сопоставительно-противопоставительный
не то…, не то	сочинительный	разделительный
не только не…, но и	сочинительный	сопоставительно-противопоставительный
не только…, но и	сочинительный	сопоставительно-противопоставительный
не только…., а и	сочинительный	сопоставительно-противопоставительный
не только…, но даже	сочинительный	сопоставительно-противопоставительный
невзирая на то что	подчинительный	уступительный
независимо от того что	подчинительный	уступительный
несмотря на то что	подчинительный	уступительный
ни…, ни	сочинительный	соединительный
но	сочинительный	противительный
однако	сочинительный	противительный
особенно	сочинительный	присоединительный
оттого	подчинительный	присоединительный
оттого что	подчинительный	причинный
отчего	подчинительный	присоединительный
перед тем как	подчинительный	временной
по мере того как	подчинительный	сопоставительный
по причине того что	подчинительный	причинный
подобно тому как	подчинительный	сравнительный
пока	подчинительный	временной
покамест	подчинительный	временной
покуда	подчинительный	временной
пока не	подчинительный	временной
после того как	подчинительный	временной
поскольку	подчинительный	причинный
потому	подчинительный	присоединительный
потому что	подчинительный	причинный
почему	подчинительный	присоединительный
прежде чем	подчинительный	временной
при всем том что	подчинительный	уступительный
при условии что	подчинительный	условный
притом	подчинительный	присоединительный
причем	подчинительный	присоединительный
пускай	подчинительный	уступительный
пусть	подчинительный	уступительный
ради того чтобы	подчинительный	целевой
раз	подчинительный	условный
раньше чем	подчинительный	временной
с тем чтобы	подчинительный	целевой
с тех пор как	подчинительный	временной
словно	подчинительный	сравнительный
так же…, как	подчинительный	сравнительный
так же…, как и	подчинительный	сравнительный
так как	подчинительный	причинный
так как…, то	подчинительный	причинный
так что	подчинительный	следственный
также	сочинительный	соединительный
тем более что	подчинительный	причинный
тогда как	подчинительный	сопоставительный
то есть	сочинительный	пояснительный
то ли…, то ли	сочинительный	разделительный
то…, то	сочинительный	разделительный
тоже	сочинительный	соединительный
только	подчинительный	временной, условия
только бы	подчинительный	целевой
только что	подчинительный	временной
только лишь	подчинительный	временной
только чуть	подчинительный	временной
точно	подчинительный	сравнительный
хотя	подчинительный	уступительный
хотя и…, но	сочинительный	сопоставительно-противопоставительный
хотя…, но	сочинительный	сопоставительно-противопоставительный
чем	подчинительный	сравнительный
чем…, тем	подчинительный	сопоставительный
что	подчинительный	изъяснительный, присоединительный
чтоб	подчинительный	целевой
чтобы
Источник: https://russkiiyazyk.ru/tablitsa/soyuzy-v-russkom-yazyke.html